||||||||||||||||||||
|E----|------------|
|-----|---|---|----|
|T-|-T|---|---|----|
|--CCC|---|---|----|
|T-|-T|---|-T-|----|
|-----|---|---|----|
|T-|-T|---|---|----|
|-----|---|---|----|
|-C-C-|---|---|----|
|-----|---|---|----|
|-M---|---|---|----|
|-----|---|---|----|
|-----|---|---|----|
|T-|-T|---|---|----|
|-----|---|---|----|
|T-|-T----|----TX|||
||||||||||||||||||||
