||||||||||||||||||||
|E-T---------------|
|---|--------------|
|---|------T-------|
|---|--------------|
|---T-----TTTTT----|
|---|-----TCCCT----|
|C--|-----TTTTT----|
|---|--------------|
|---|--------------|
|---|--------C-----|
|---|--------------|
|---|------T-------|
|---|--------------|
|---|--------------|
|---|--------------|
|---|--------------|
|---|------T----X--|
||||||||||||||||||||