||||||||||||||||||||
|E-----------------|
|--||||||||||||||--|
|-T|------------|T-|
|--| |||||||||| |--|
|---| |------| |---|
|---| |C--T--| |---|
|---| |------| |---|
|--| |||||||||| |--|
|-T|------------|T-|
|--||||||||||||||--|
|------------------|
|-----------------X|
||||||||||||||||||||