||||||||||||||||||||
|E---T-------|-----|
|----|-------|-----|
|----|---T---|-----|
|----|-------|-----|
|-----T-------|----|
|----|--------|----|
|C---|--------|----|
|----|--------|----|
|----|----T---|----|
|-------------C----|
|----|--------|----|
|----|--------|----|
|----|--------|----|
|----|--------|----|
|----|--------|----|
|----|--------|----|
|----|----T---X----|
||||||||||||||||||||
