||||||||||||||||||||
|E-----------------|
|--||||||||||||||--|
|-T|------------|T-|
|--|------------|--|
|---|-|------|-|---|
|---T-|C--T--|-T---|
|---|-|------|-|---|
|--|--||||||||--|--|
|-T|------------|T-|
|--||||||||||||||--|
|------------------|
|-----------------X|
||||||||||||||||||||