||||||||||||||||||||
|E---T-------------|
|------------------|
|------------------|
|------------T-----|
|------------------|
|-----T------------|
|------------------|
|C-----------------|
|------------------|
|------------------|
|-------------C----|
|------------------|
|------------------|
|------------------|
|--S---------------|
|------------------|
|------------------|
|----------------TX|
||||||||||||||||||||