||||||||||||||||||||
|E-----------------|
|------------------|
|------------------|
|------------------|
|------------------|
|------------------|
|------------------|
|C-----------------|
|------------------|
|------------------|
|-------------C----|
|------------------|
|------------------|
|------------------|
|------------------|
|------------------|
|------------------|
|-----------------X|
||||||||||||||||||||